   #####
   #@ .#
####$ .#
#   $  #
#   #  #
########
