########
#  #@  #
#  $ # #
# $    #
##  ####
 # .#   
 # .#   
 ####   
